50 5 1

3 -2 0 -5
3 2 0 -5

1 -2 0 -6
1 2 0 -6	

1 -2 0 -7
1 2 0 -7	

1 -2 0 -8
1 2 0 -8	


1 -2 0 -9
1 2 0 -9	
1 -2 1 -9
1 2 1 -9	
1 -2 2 -9
1 2 2 -9		
1 -1 2 -9
1 1 2 -9	
1 0 2 -9

1 -1 0 -10

1 -2 0 -10
1 2 0 -10	

1 -2 0 -11
1 2 0 -11	

1 -2 0 -12
1 2 0 -12	

1 -2 0 -13
1 2 0 -13	
	

1 -1 0 -13

1 -2 0 -14
1 2 0 -14	
1 -2 1 -14
1 2 1 -14	
1 -2 2 -14
1 2 2 -14		
1 -1 2 -14
1 1 2 -14	
1 0 2 -14

1 -1 0 -15

1 -2 0 -15
1 2 0 -15	

1 -2 0 -16
1 2 0 -16	

1 -2 0 -17
1 2 0 -17	

1 -2 0 -18
1 2 0 -18
1 -2 0 -19
1 2 0 -19	

1 1 0 -19

1 -2 0 -20
1 2 0 -20
1 -2 0 -21
1 2 0 -21			
1 -2 0 -22
1 2 0 -22
1 -2 0 -23
1 2 0 -23		
1 -2 0 -24
1 2 0 -24
1 -2 0 -25
1 2 0 -25	
1 -2 0 -26
1 2 0 -26	
1 -2 0 -27
1 2 0 -27	
1 -2 0 -28
1 2 0 -28	
1 -2 0 -29
1 2 0 -29	
1 -2 0 -30
1 2 0 -30	
1 -2 0 -31
1 2 0 -31	

1 -2 0 -32
1 2 0 -32	
1 -2 1 -32
1 2 1 -32	
1 -2 2 -32
1 2 2 -32		
1 -1 2 -32
1 1 2 -32	
1 0 2 -32