16 5 1

3 -2 0 -5
3 2 0 -5
1 -2 0 -6
1 2 0 -6	
1 -2 0 -7
1 2 0 -7	
1 -2 0 -8
1 2 0 -8	
1 -2 0 -9
1 2 0 -9	
1 -2 1 -9
1 2 1 -9	
1 -2 2 -9
1 2 2 -9		
1 -1 2 -9
1 1 2 -9	
1 0 2 -9